5
###########
#323#37179#
#1#298##9##
#3#9#8#279#
#2#9#8#5#8#
#126#T#264#
#9#2#####9#
#5#8#53549#
#9#1#1###5#
#741273963#
####B######
