50
###############################################################################B#####################
#7#8#5#85476#818#1#6#188#1#95881#6#6#9617996#9#9#9#775#77124#7#233#556#42545#31968#8998739#8#959#1#4#
#3#1#1#9#####7###1#4#2#8#1#3#7###1#5###7#1#8#5#9#6#8#5###3###8#6###2#######1#7#1#7#7#######1###3#5#2#
#196#3#6#4#24326#9#9#5#1#293#7#348#4#221#3#824#6#242#4#8#748#3#4#228#2#374#159#4#153#6#2#579#1649892#
###6#1#8#5#3#####5#8#2###7###3#7#2#8###2#4#####9#####3#4#9#2#9#5###3#4#1#8#####4#4#4#7#5#1###1###5#8#
#684#45693#613#4#8#962#24388#2#8#463#8#4#3#1#852#942#9#5#5#5#48483#7#4#4#8#7#172#1#1#7#69817#3#6#4#8#
#4#1#6#4#3###8#1#2###5#9#####4###9#7#4#4#6#3###9#3#9#4#8#2#7###1#2#2#4#2###1#3#######2#####9#6#2#####
#9#488#3#4#5#3#22192#7261455#13162#1#3#5#18462#989#1#912#8#641#6#189#56569#5#626#173#4#755#25679#155#
#######8#8#4#1#5###########7#7#6#####4#######2###3#3###4#4#####5###2#9#####8#4#1#2###5###8#2#####6#4#
#779#965#7#4#7#114#5731942#4#7#953#4#4#7731954#564#7#9#52683#3#366#95245924929#7#4#416#53339#8#4#1#5#
#9###7#####1#3#1#####9#######6#####8#3#5#####7#9#8###7#3#6###2#####4###2#####7###3#2#####2###6#9###8#
#9#864#231#4#7#458#284#636#6#5#5#5#5#4#7#88635#4#552#4#3#8#84155#8#8#4#18189#833#738#7#3#1#3#245#6#6#
#4#4#9###7#6#4#7#####5#2###2#7#5#1#6#3#9#7###2###7###7#8#####4###3###5###2#3#8#4###3#1#9#1#9#7###2#4#
#672#3#361#2#78629#8#48756#6#3696278#8#8#1#19138#4#9#11273#11363#979721494#9#7#2#54836#645#9#9#192#1#
###5###1###7#####6#7#6#####5#5#####5#9###6###2###3#3#9#4###9#####3#3###5#2###########6#7###1#1#8###4#
#681#68879#5#33334#7#9#26761#9#2#39514#3#675#574#2#887#4#2#1#77143#932#4#426847866#154#3#574#4#28662#
#5#3#####9#5###2#6#2#5#9#####3#2#5#####3#2###2###3#8#####4#2#####5###6#7###6#8###2###9#2#9###3#2#2#4#
#7#5621146#4#1#4#372#3#35587#163#451#8#6#916#9#69554#448#617#1#96885#3#626#8#179#4#4#42895217377#1#6#
###1#######9#1#5#####1###8#####7#####1#7#1###8###9#7#9#9###6#9#1#7#5#####6#4###4###3#3#####3#######2#
#577#2#7#364#7#1#4929292#629#412#8#293218248#5#5#7#617#439#61714#4#5#2#215#997#1#368489792#6#7#673#7#
#5#6#5#1#2###6#9#8#7###9#9###2#4#3#2#5#7#3#1#3#3#7###6#######6###2###7#1#3###2#6#8#1#####7###5#6#3#8#
#4#6546469#2#4#4#4#759#6494684#12592#1#2#9#2#3#699#943866295#1#8#2#4#454#2#2#6#661#196#9#1332263#4#3#
###9#######2#7#1###5#########4#5#4#8#####6#3#6#9#6#1#9#9###6#8#6#5#7###2###6###7#7#1#9#1#7#####1###9#
#1#252#9#1#82343#5#3#7#4#775#4#7#1#4#6#891#9#9#7#2#2#6#128#92494#256#451182921#1#8#5#622#517#9#545#7#
#8#1###8#7###5###1###2#9###1#####3#1#4###2###1#####7#8###5#7#7###2#####8#2#3#2#2#####9#7#1###6###2###
#8977974#2#98769688883#2#93162#4#8#2#3#4#299#869#4#3#6#5#8#7#187#23687#6#5#7#7#6#153#4#2#9812418#1#8#
#####1###4#####4#######8#2#####4#7###8#7###4#####5#8###2#######5#####5#4#6#3#####5#####4#4#####3###1#
#166#789#1#9#2#155#9#5#31365#349#7#8636911#9#543#445#82222#394639949#5#3#7#3#58855#7#4#3#1#88893#9#8#
#3###3###3#9#8#2#6#8#9#2#1#8#7###5#9#9###7###5###4###7#8###9#####9#####7#4#3#####8#4#9#3#5#9#9###9#9#
#8#7#966#1#12311#699#995#8#329#93486#257#21285#3#9#539#5194626#4#79818#8#8#7#29455#3#633#8#7#3#396#3#
#8#9#6###4#2#####6#6###7#######8###3#####6#####3#9###7#4#7###2#6#1#####9#1###8###7#8###8###8#####4#4#
#92583#9#765#5#3#9#7#7#865#539#3#6272323#716#5#5#336#3#9#988#7#234#6#6#2#2#3#934#262#175#2#7#883#1#7#
###9#2#4#6#6#8#8#3###1#7###2###8###5#9#3#####5#1#8###7#####8#6###3#5#7###6#2#######5#6#9#5###4#4#3#9#
#518#486#6#79489#6#998#4#415#21483#9#5#4#5#473#2#165#43891#1#1#7#9#46896#8#8#3#35232#2#4723459#23966#
###3###2#######3#1###2#4#6###5###9###7#2#9#1#8#7#####5#3###8#5#7###9#8#6#3#8#7#3#2#####6#####7###8###
#9#641#6354384#5#972#8#456#4#2#1#1#987#2#7#9#21115#9#1#954#5#163#1#2#2#9#2#835#1#3#652#883#35792#4#5#
#7#5###########3###1#1###7#4#8#2###3#####5#2###7###8###1#8###3#9#1#3###6#6#4#4#6###4#8###8#####9#8#6#
#943#24455#694#737#9#6#937#783#257#15116#9#423#263442385#4#1#9#76169#3#8#331#14117#7#9#338#1#8#8#762#
#8#####4#6#8#####4###9#1#3#7#####7#1#2#3#3#######1###5#####9#####4#5#7#5#####5#######1#####8#9###3###
#61828#4#93451677932#5#1#8#3#873#176#8#5#4#9#3#7#111#879#34644#978#259#4#242#868#67871#135#1#7#6#814#
#3#5###6#2#4#7###9###5#2#####1#####2#7#8#8#3#4#6#5#####6#7#####7#########3###3###9#2###7#4#3#4#6#4###
#3#336#3#7#1#6#7#687#5#5144314#8#9#4#7#562#3#85457#294222662#78466368778#314278984#8#836#67463#7#158#
###7#6#3#9#2###8#####6#5#######5#3#1#####5#7#######8#8#9###7#6###1###4#1#2#######5###9#########9#5#9#
#7#7#544#9#9#63339#773#2#397#641#56158#916#127#459#5#7#4#6#4#495#933#9#6#5#577#411#6#4665569#6#932#8#
#2#8#7#####1#####3#9#4#2#9###2#####2#4#6#8#4###8#########9###6#####8#5#9#5#5#######6###2#1###3#######
#961#3#8#97479#8#2#7#778#893#4#44143#7#2#89624#343#739131872#193#126#4#1#14287#3#1576927#5#33377#343#
#3#####1###7###3#7#2###4###3#1#5#9###1###6#5###7#3###9#8###8#6#6#####6###4#8#7#6###1###9#####2#2#4###
#7#21693#44622#5#45418#141#93158#646#8#437#2#2#6#128#2#2#69583#9#7#86871#3#6#7#7#759#8#3184593#6#2#5#
#9###4###6#4###3#3#########1#9#6#4#####9#####5#3###1###5###1#####2###7###1#3###5#####3###8#3#1#3#5#2#
#6647251#9#5#9#4#6#974#9#1#1#1#3#68887#5#8#883#972#149#978#475#8#1#2#6#551#583#7#1#1#358#9#3#4#86811#
#7###5#3#####3#1#7#9#7#4#5#####9###3#####1###3#3###2#4#7###5###7#1#1#########4#9#1#6#3#####7###3###3#
#7#363#8#3#195#3#846#9#934#382#1#98161#166#1#25313#1#53125#2#8#75321#5#4#243#935199234#8673418#9#925#
#1#9#6#9#7#5###7#9###1#3#####5#8###3#1#9###6#####7###1#9#2###5###4###3#7###9###8###9###1###5#2#8#9###
#7#3#6#651#9#4#5#381#138#135#661#1#9#25127#6852742#784#3#289554936#699#8559695#135#2#37891#3#2#8#5#5#
#8#5###6###9#4#6#3#######9#####7#7#5#9###8#1#######5#2#3#######6#####3#######7#######2###5#########8#
#6#464#8#6#2#9#1#1#2#2#6#5#9#2#362#7#6#9#8#8#1#533#2#4#9586437#6#1419728#1#58255#983#282#7#631#214#5#
#####2###2#5#6#7#1#5#7#9#2#5#2#8#3###5#9#####7###5###7#####5#8#1###4#####7###6#4#7###7#6###8#8#7#7#5#
#25998#2#1#79234#833#1#5#5#3#782#585#32956#6#5#238#1#6#29842#2#1#686#571#9#818#682#9#7#4#4#2#456#999#
#####4#1#8###5#9###2#4#8#8#9#5#5#########3#1#8###1#1###2#9#5###7###9#3#3#8#3###9#4#7#5#1#8#####2#####
#6#8#564#373#8#5#695#8#21971#3#17283#3926582#77773355446#8#314#197#6#9#4#3#7#3#4#9#922#59149#51855#1#
#7#2#7#####8#1###2###8###8#####9###4#######5#######9#1###8#3#7#####1#6#9#5###7#6#8#######8###8###5#7#
#397#9#75323#916#698#367#8#4164267#887#1#77829#667#7#9#3#6#5#4#9#69144#661#8#2#5#513#8648552#8#81936#
#8###5###4#6###4###2#8###3#3#####9#1#2#5#2###1#1#6#4###6#####5#3###8#4#1#2#1#4#4###3#4#5#8###9#####6#
#5#87167#9#682684697#42719#14946#2#4#3#13779#562#293#1244441#1#12644#8#6#4#1#96957#5#9#9#7#148#4#434#
#5#####1#9#######7#######1###5#5###4###5#4#8#######9###4#8#2#7###3#4#1#7#4#8#8#2###5###8#######3#2###
#29141#9792825#7#6365876#5#199#391#351#3#7#2998439#216#9#7#8#6#685#2#4#1#4#2#2#571#2#2#7232376#571#3#
#8#####6#8#2###3#3###4###5###2###2#1###5#1#6#########6#3#####7#8#####1###8#2#8#6#####5#1#9#6#7###2#8#
#4#615#4#3#985#235#2#393#48744#597#3#7#7#8#1#7#T#7#85815#1#6#6#978#69114#92614#5#2#53442#8#1#135#4#6#
#6#1###4#####5#8###3#8#4###6#2#3###2#9#9#6#8#7#1#7#####8#8#8#2#8#3###5###2#3###6#5###5#5#########6#8#
#17115#19869#1#337#559#444#9#4#971#663#8#2#761#4#7577954#398#9#6#191#8#824#356#496#624#1#2#6#4#5#5#3#
###9#3###4#3#9###4#7#######9#4#1#####1###7###2#9###4#####6#8#2#1#8###5#########7#7###7#3#4#6#4#7#1#6#
#867#2#9#3#6#946#9#6#11921#6#2#5#8#4#952#769#84356#721#931#142#4#2#697#371#2#625#919#1#9#4#3#15919#7#
#7###5#6###7#6###5###5#######9#7#2#7###########9#4#2#6#8###4###7#####5#7###4#6###7###3#9#3#2#####3#2#
#9#4#569#523#3#9#4#6665518#6#1#1#686#8#1972276#9#7#6#3#333#4#6#8#4#6#93177#521#7#572#8#8#8818416#6#5#
###9###8#######9#9#9#######5###5###4#2###7###1#3#####7#####8#8#2#8#8###2#######1#4#4#8###1#####4#3#4#
#5#22888#974#6#6532143#1#4#47576895786#95428#8#599#9#8#6#727#6972666#9283733#4#571#49633#7#4#4#5#477#
#1#6#####2###6#2#5#7###1#9#######2#####2#4#9#1#2#2#5###7###4###9#######7###5#2#1###5#6#2###6#2#8#1###
#4#458#4#8#1#2#2#3#6#436#6#3#3#3#51379#7#6#8#574#1#5#521#9#5#31562#474#621#3#6#9#7#7#4#5#3#6#7#423#3#
#4#3#1#7#6#4#5#1#######4#5#5#5#6###4#6#####9#####5#7#8###5#3#######4#########9###2#####7#1#6#1#8###3#
#4#9#4#4#8#3#5#81243#272#6#6#928#353#628#7277971#959#77242#238#574639594#8#391357451#9#2#166994373#6#
#7###4#8#3#8#3#####2#4###7#1###5#2#5#1#7#####4#####1#####8#8#9###4#####3#9#2#1#####4#2#6###3#######5#
#3#9328438#967#5#167#31122#56421#8#5#1#526#9#7#4#1#6#2#2#4#4#8#7#5#35265#152#6#88732#64336#1#1#87693#
#2#2#########9#1#1###1#7#6#5#####9#9#6#####8###8#5###7#8#6###8#9###1###3#3###2#####9#8###7#2#1#####2#
#9#4325494#1#626#5#251#2#351#4#5#5#9#6359448#915331854#9#3#2#69315#4#9#58967#7#13926#899#118#7742124#
#1###6#9#1#4#3###5#2#2#8###7#2#1#######7#8#5#9#########4#2#5#1#####9#8###8###6#5#####2###8#7#6#######
#8#842#9#9#9#12492#1#6#839#696#5#4#4#466#2#743#7#813#8#9#6#131#578#1#17198#752#39638#145#1#329#71242#
#6#3#5#4###8#2###########1#####1#8#9#####3###2#8#1###6#1#6#2###3###5#8###6#####6#6#1#4###8#5#7###3###
#2#5#3#711#2#1#787#5#632#7#6#1#4#5#269#8#443#364#77455#247889732#577#7#6#4#421#4#4#92635#9#3#8#644#1#
#9#2#7#5#1#5#7###7#7#2#8#1#4#2#5#5#7###7#1###6#2#7#####1#####5###3#3#9#6###8#7###2#####4#2#######5#6#
#357#4#5#6#6#5#146#448#878#9#4#3#1#7#467#8#246#2#2#4#14778#556#722#5#9#7#558#4#2#385#256#8#967125481#
###1#######7#2#4###9#5#7#5#1#8#7#3#7###5#5#######5#6#9#6#2#1#1#4###1#6#9#####8#9#######4#####3#######
#532#9#6#5#959#122#4#3#2#4#4#4756691#9#5#2#8#6#2#6#8#6#5#4#6#8#1#3#7#877#8#9#6#9#223#6#2#653765857#5#
#2###2#9#4###9#3#3#5#######5#5#5###4#7#6#7#9#4#5#4#6###########5#5#####7#7#6#5#2#6###5#2#8###7#1#6#1#
#182#3#371#8#726#6178136#3#171#993#736#4#53372#473#66445#461#5#215#9#17696#69237#871#628#5#7#7#7#1#3#
#9#4#8#6###4#######2#9#4#2#7###########3#9###6#9#####3#1###9#1#4###2#######4#####9#4#######3###8#2#7#
#9#83874#93686#534#5#8#9#322#4#1#789#18645#994#3#73937#896#7#6#585148766#7881252#8#598#865#56357#189#
#1#9###3###6#####7#6#####6###2#3#6#####2#######9#8#8#####8#8#3#4#1#######5#1#1#4#4#####2#######5###8#
#7#634#6#5#2#8#463#946454825#814#8#859#4#9#395#667#1#1#2#7#4#1#8#9#57669#5#2#3#8#231#6#443951575#7#4#
#7#######1#8#1#1###1#########7###4#8###4#1#7###7#####2#9###2#4#7#2#####3#2#5###2#7###7#######3###9###
#251675428188914366775216232396967319437277948293255778812945177#437394573#467#737579753539282598649#
#####################################################################################################
