5
###########
#311#44134#
###8###6###
#521#T#939#
#5#1#8###4#
#2#8#2#6#5#
###9#2#3#9#
#7#981#523#
#8#2#####9#
#162158348#
#####B#####
